11111111111111111111
10000000040000000001
10202020200000000001
10000000000000000001
10000001000000000001
11111111000000000001
10000001000000000001
10000001000000000001
10000000000000000001
10000000000000000001
10000000000000000001
10000000000000000001
10000000000000000001
10000000003000000001
10000000000000000001
11111111111111111111

40020020000020002000
00000000000000000000
11111111000011111111
00000000000000000000
00000000000000000000
00000011111111000000
00000000000000000000
00000000000000000000
11111111000011111111
00000000000000000000
03000000000000000000
00000000000000000000
00000000000000000000
00000000000000000000
00000000000000000000
00000000000000000000

11111111111111111111
10000000000000000001
10200000000000000201
10000000000000000001
10002000000000020001
10000000000000000001
10000020000002000001
10000000000000000001
10000011100111000001
10000010000001000001
10011110400001111001
10000010000001000001
11110311111111001111
10000000000000000001
11111111111111111111
00000000000000000000

11111111111111111111
10000000040000000001
10000000000000000001
11111110000001111111
10000000000000000001
10010020202020001001
10010000000000001001
10010000000000001001
10010000000000001001
10000000000000000001
10000000000000000001
10000000000000000001
10000000003000000001
10000000000000000001
11111111111111111111
